`global-disable-mouse-mode' Minor Mode Bindings: :: ignore
`drag-stuff-mode' Minor Mode Bindings:           :: ignore
`auto-complete-mode' Minor Mode Bindings:        :: ignore
<*>                                              :: ignore
<f1> *          helps(another)                   :: xxx-withdrawal
<help> *	helps                            :: xxx-withdrawal
<f2> 2		2C-two-columns                   :: xxx-withdrawal
<f2> b		2C-associate-buffer              :: xxx-withdrawal
<f2> s		2C-split                         :: xxx-withdrawal
<f2> <f2>	2C-two-columns                   :: xxx-withdrawal
C-x C-k *       kmacros                          :: xxx-withdrawal

Key translations:
key             binding
---             -------
C-x 8 *		iso-transl-ctl-x-8-map           :: xxx-withdrawal

`yas-minor-mode' Minor Mode Bindings:
key             binding
---             -------
TAB		yas-expand
<tab>		yas-expand

C-c &		Prefix Command
C-c & C-n	yas-new-snippet
C-c & C-s	yas-insert-snippet
C-c & C-v	yas-visit-snippet-file

`fancy-narrow-mode' Minor Mode Bindings:
key             binding
---             -------
C-x n		Prefix Command
C-x n b		org-fancy-narrow-to-block
C-x n d		fancy-narrow-to-defun
C-x n e		org-fancy-narrow-to-element
C-x n n		fancy-narrow-to-region
C-x n p		fancy-narrow-to-page
C-x n s		org-fancy-narrow-to-subtree
C-x n w		fancy-widen

`auto-highlight-symbol-mode' Minor Mode Bindings:
key             binding
---             -------
<M-S-left>	ahs-backward-definition
<M-S-right>	ahs-forward-definition
<M-left>	ahs-backward
<M-right>	ahs-forward

C-x C-a		ahs-edit-mode
C-x C-'		ahs-change-range

M--		ahs-back-to-start

key             binding
---             -------
C-c		Prefix Command

C-c /		Prefix Command

C-c / SPC	google-this-region
C-c / a		google-this-ray
C-c / c		google-this-translate-query-or-region
C-c / e		google-this-error
C-c / f		google-this-forecast
C-c / g		google-this-lucky-search
C-c / i		google-this-lucky-and-insert-url
C-c / l		google-this-line
C-c / m		google-maps
C-c / n		google-this-noconfirm
C-c / r		google-this-cpp-reference
C-c / s		google-this-symbol
C-c / t		google-this
C-c / w		google-this-word
C-c / <return>	google-this-search

Major Mode Bindings:
key             binding
---             -------
C-M-i		completion-at-point
C-M-q		indent-pp-sexp
C-M-x		eval-defun

Global Bindings:
key             binding
---             -------
C-@		set-mark-command
C-a		Prefix Command                  :: prefix
C-b		backward-char                   :: well known
C-d		delete-char                     :: well known
C-e		Prefix Command                  :: prefix
C-f		forward-char                    :: well known
C-g		keyboard-quit                   :: well known
C-h		delete-backward-char            :: well known
C-j		electric-newline-and-maybe-indent: well known
C-k		kill-line                       :: well known
C-l		insert-parenthesis              :: well known
RET		forward-paragraph               :: withdrawal
C-n		next-line                       :: well known
C-o		open-line                       :: well known
C-p		previous-line                   :: well known
C-q		undo                            :: undo
C-r		isearch-backward                :: well known
C-s		isearch-forward                 :: well known
C-t		transpose-chars                 :: well known
C-u		universal-argument              :: well known
C-v		scroll-up-command               :: well known
C-w		kill-region                     :: well known
C-x		Control-X-prefix                :: prefix
C-y		yank                            :: well known
C-z		Prefix Command                  :: prefix
ESC		ESC-prefix                      :: prefix
C-\		toggle-input-method             :: well known(unuse)
C-]		abort-recursive-edit
C-_		undo                            :: undo
C-S-l		insert-angle-brackets           :: well known(my command)
C-SPC		set-mark-command                :: well known
C--		negative-argument
C-.		goto-next-TODO                  :: well known(my command)
C-/		undo                            :: undo
C-0 .. C-9	digit-argument
C-:		insert-underscore
C-!		highlight-symbol-prev
C-?		highlight-symbol-next

C-a C-a		comment-dwim                    :: well known(my command)
C-a C-d		insert-date-normal              :: well known(my command)
C-a C-f		merge2lines                     :: well known(my command)
C-a C-k		kill-this-buffer                :: well known(my command)
C-a RET		insert--s                       :: well known(my command)
C-a C-p		downcase-word                   :: well known(my command)
C-a C-u		upcase-word                     :: well known(my command)
C-a ESC		Prefix Command                  :: prefix
C-a 1		??                              :: well known(my command)
C-a 2		??                              :: well known(my command)
C-a 3		??                              :: well known(my command)
C-a 4		??                              :: well known(my command)
C-a 5		??                              :: well known(my command)
C-a 6		??                              :: well known(my command)
C-a 7		??                              :: well known(my command)
C-a 8		??                              :: well known(my command)
C-a 9		??                              :: well known(my command)
C-a M-d		insert-date-markdown            :: well known(my command)

C-e C-a		move-beginning-of-line          :: well known(my command)
C-e C-b		previous-buffer-with-skip*      :: well known(my command)
C-e C-c		shell                           :: well known(my command)
C-e C-d		vr/query-replace                :: well known(my command)
C-e C-e		move-end-of-line                :: well known(my command)
C-e C-f		next-buffer-with-skip*          :: well known(my command)
C-e C-j		point-undo                      :: well known(my command)
C-e C-k		point-redo                      :: well known(my command)
C-e C-l		recenter-top-bottom             :: well known(my command)
C-e C-n		highlight-symbol-next           :: well known(my command)
C-e C-p		highlight-symbol-prev           :: well known(my command)
C-e C-r		search-backward-regexp          :: well known(my command)
C-e C-s		search-forward-regexp           :: well known(my command)
C-e C-v		move-to-scratch                 :: well known(my command)
C-e C-w		move-to-repl                    :: well known(my command)

C-z C-b		grep-this                       :: well known(my command)
C-z C-f		grep-find-this                  :: well known(my command)
C-z C-k		describe-bindings               :: well known(my command)
C-z C-o		nurumacs-map-toggle             :: well known(my command)
C-z C-r		replace-string                  :: well known(my command)
C-z C-s		swoop                           :: well known(my command)
C-z C-t		bm-toggle                       :: well known(my command)
C-z ESC		Prefix Command                  :: well known(my command)
C-z f		set-file-name-coding-system     :: well known(my command)
C-z m		magit-status                    :: well known(my command)
C-z p		toggle-truncate-lines           :: well known(my command)
C-z r		google-this                     :: well known(my command)
C-z s		make-buffer-small               :: well known(my command)
C-z t		bm-show                         :: well known(my command)

C-x C-@		pop-global-mark
C-x C-b		list-buffers
C-x C-c		save-buffers-kill-terminal     :: well known
C-x C-d		list-directory
C-x C-e		eval-last-sexp
C-x C-f		find-file                      :: well known
C-x TAB		indent-rigidly
C-x C-j		dired-jump
C-x C-k		kmacro-keymap                  :: xxx-withdrawal
C-x C-l		downcase-region
C-x RET		Prefix Command
C-x C-n		set-goal-column
C-x C-o		delete-blank-lines
C-x C-p		mark-page
C-x C-q		read-only-mode
C-x C-r		find-file-read-only
C-x C-s		save-buffer
C-x C-t		transpose-lines
C-x C-u		upcase-region
C-x C-v		find-alternate-file
C-x C-w		write-file
C-x C-x		exchange-point-and-mark
C-x C-z		suspend-frame
C-x ESC		Prefix Command
C-x SPC		rectangle-mark-mode
C-x #		server-edit
C-x $		set-selective-display
C-x '		expand-abbrev
C-x (		kmacro-start-macro            :: xxx-withdrawal
C-x )		kmacro-end-macro              :: xxx-withdrawal
C-x *		calc-dispatch
C-x +		balance-windows
C-x -		shrink-window-if-larger-than-buffer
C-x .		set-fill-prefix
C-x 0		delete-window                 :: well known
C-x 1		delete-other-windows          :: well known
C-x 2		split-window-below            :: well known
C-x 3		split-window-right            :: well known
C-x 4		ctl-x-4-prefix
C-x 5		ctl-x-5-prefix
C-x 6		2C-command
C-x 8		Prefix Command
C-x ;		comment-set-column
C-x <		scroll-left
C-x =		what-cursor-position
C-x >		scroll-right
C-x [		backward-page
C-x ]		forward-page
C-x ^		enlarge-window
C-x `		next-error
C-x a		Prefix Command
C-x b		switch-to-buffer
C-x c		helm-command-prefix
C-x d		dired
C-x e		kmacro-end-and-call-macro
C-x f		set-fill-column              :: xxx-withdrawal
C-x h		mark-whole-buffer
C-x i		insert-file                  :: insert file content
C-x k		kill-buffer
C-x l		count-lines-page             :: xxx-withdrawal
C-x m		compose-mail                 :: xxx-withdrawal
C-x n		Prefix Command               :: prefix
C-x o		other-window                 :: well known
C-x q		kbd-macro-query              :: xxx-withdrawal
C-x r		Prefix Command               :: prefix
C-x s		save-some-buffers
C-x u		undo
C-x v		vc-prefix-map
C-x z		repeat
C-x {		shrink-window-horizontally
C-x }		enlarge-window-horizontally
C-x DEL		backward-kill-sentence
C-x C-SPC	pop-global-mark
C-x C-+		text-scale-adjust
C-x C--		text-scale-adjust
C-x C-0		text-scale-adjust
C-x C-=		text-scale-adjust
C-x <C-left>	previous-buffer
C-x <C-right>	next-buffer
C-x <left>	previous-buffer            :: well known
C-x <right>	next-buffer                :: well known

M-0 .. M-9	digit-argument

C-M-@		mark-sexp
C-M-a		beginning-of-defun
C-M-b		backward-sexp
C-M-c		exit-recursive-edit
C-M-d		down-list
C-M-e		end-of-defun
C-M-f		next-buffer-with-skip*
C-M-h		mark-defun
C-M-j		indent-new-comment-line
C-M-k		kill-sexp
C-M-l		reposition-window
M-RET		yas-insert-snippet
C-M-n		forward-list
C-M-o		split-line
C-M-p		previous-buffer-with-skip*
C-M-r		isearch-backward-regexp
C-M-s		isearch-forward-regexp
C-M-t		transpose-sexps
C-M-u		backward-up-list
C-M-v		scroll-other-window
C-M-w		append-next-kill
ESC ESC		Prefix Command
C-M-\		indent-region
M-SPC		just-one-space
M-!		shell-command                :: shell command
M-$		ispell-word
M-%		query-replace
M-&		async-shell-command
M-'		abbrev-prefix-mark
M-(		insert-parentheses
M-)		move-past-close-and-reindent
M-*		pop-tag-mark
M-,		tags-loop-continue
M-.		find-tag
M-/		dabbrev-expand
M-:		eval-expression
M-;		comment-dwim
M-<		beginning-of-buffer          :: well known
M-=		count-words-region
M->		end-of-buffer                :: well known
M-@		mark-word
M-\		delete-horizontal-space
M-^		delete-indentation
M-`		tmm-menubar                  :: xxx-withdrawal
M-a		ace-jump-mode                :: learned
M-b		backward-word                :: well known
M-c		capitalize-word              :: capitalize word
M-d		kill-word                    :: zzz-normal
M-e		forward-sentence
M-f		forward-word                 :: well known
M-g		Prefix Command               :: prefix
M-h		backward-kill-word           :: well known
M-i		tab-to-tab-stop		     :: tab stop
M-k		kill-sentence
M-l		insert-brackets              :: well known (my command)
M-m		backward-paragraph
M-n		scroll-down-in-place         :: well known (my command)
M-o		facemenu-keymap
M-p		scroll-up-in-place           :: well known (my command)
M-q		redo                         :: well known (my command)
M-r		move-to-window-line-top-bottom
M-s		Prefix Command               :: prefix
M-t		transpose-words              :: well known
M-u		upcase-word
M-v		scroll-down-command          :: well known
M-w		kill-ring-save               :: well known
M-x		execute-extended-command     :: well known
M-y		yank-pop                     :: well known
M-z		zap-to-char                  :: delete until target char (forward)
M-{		backward-paragraph           :: move paragraph (backward)
M-}		forward-paragraph            :: move paragraph (forward)
M-|		shell-command-on-region
M-~		not-modified
M-DEL		backward-kill-word           :: xxx-withdrawal
C-M-S-v		scroll-other-window-down     :: scroll other window down (for 2 windows)
M-S-l		insert-squares               :: zzz-normal(my command)
C-M-SPC		mark-sexp
C-M-%		query-replace-regexp
C-M--		negative-argument
C-M-.		find-tag-regexp
C-M-/		dabbrev-completion
C-M-0 .. C-M-9	digit-argument

ESC <C-backspace>backward-kill-sexp
ESC <C-delete>	backward-kill-sexp
ESC <C-down>	down-list
ESC <C-end>	end-of-defun
ESC <C-home>	beginning-of-defun
ESC <C-left>	backward-sexp
ESC <C-right>	forward-sexp
ESC <C-up>	backward-up-list
ESC <begin>	beginning-of-buffer-other-window
ESC <end>	end-of-buffer-other-window
ESC <f10>	toggle-frame-maximized
ESC <home>	beginning-of-buffer-other-window
ESC <left>	backward-word
ESC <next>	scroll-other-window
ESC <prior>	scroll-other-window-down
ESC <right>	forward-word

M-s .		isearch-forward-symbol-at-point
M-s _		isearch-forward-symbol
M-s h		Prefix Command
M-s o		occur
M-s w		isearch-forward-word
M-o ESC		Prefix Command
M-o b		facemenu-set-bold
M-o d		facemenu-set-default
M-o i		facemenu-set-italic
M-o l		facemenu-set-bold-italic
M-o o		facemenu-set-face
M-o u		facemenu-set-underline
M-g TAB		move-to-column
M-g ESC		Prefix Command
M-g c		goto-char
M-g g		goto-line
M-g n		next-error
M-g p		previous-error
M-ESC ESC	keyboard-escape-quit
M-ESC :		eval-expression

C-x RET C-\	set-input-method
C-x RET F	set-file-name-coding-system
C-x RET X	set-next-selection-coding-system
C-x RET c	universal-coding-system-argument
C-x RET f	set-buffer-file-coding-system
C-x RET k	set-keyboard-coding-system
C-x RET l	set-language-environment
C-x RET p	set-buffer-process-coding-system
C-x RET r	revert-buffer-with-coding-system
C-x RET t	set-terminal-coding-system
C-x RET x	set-selection-coding-system

C-x ESC ESC	repeat-complex-command :: xxx-withdrawal
C-x M-:		repeat-complex-command :: xxx-withdrawal

C-x 4 C-f	find-file-other-window            :: find file other
C-x 4 C-j	dired-jump-other-window
C-x 4 C-o	display-buffer                    :: open list of buffer
C-x 4 .		find-tag-other-window		  :: required tag-jump
C-x 4 0		kill-buffer-and-window            :: kill buffer and window
C-x 4 a		add-change-log-entry-other-window
C-x 4 b		switch-to-buffer-other-window
C-x 4 c		clone-indirect-buffer-other-window
C-x 4 d		dired-other-window
C-x 4 f		find-file-other-window
C-x 4 m		compose-mail-other-window
C-x 4 r		find-file-read-only-other-window

C-x 5 C-f	find-file-other-frame
C-x 5 C-o	display-buffer-other-frame
C-x 5 .		find-tag-other-frame
C-x 5 0		delete-frame
C-x 5 1		delete-other-frames
C-x 5 2		make-frame-command
C-x 5 b		switch-to-buffer-other-frame
C-x 5 d		dired-other-frame
C-x 5 f		find-file-other-frame
C-x 5 m		compose-mail-other-frame
C-x 5 o		other-frame
C-x 5 r		find-file-read-only-other-frame

C-x 6 2		2C-two-columns
C-x 6 b		2C-associate-buffer
C-x 6 s		2C-split
C-x 6 <f2>	2C-two-columns

C-x 8 RET	insert-char

C-x a C-a	add-mode-abbrev
C-x a '		expand-abbrev
C-x a +		add-mode-abbrev
C-x a -		inverse-add-global-abbrev
C-x a e		expand-abbrev
C-x a g		add-global-abbrev
C-x a i		Prefix Command
C-x a l		add-mode-abbrev
C-x a n		expand-jump-to-next-slot
C-x a p		expand-jump-to-previous-slot

C-x c C-c	Prefix Command
C-x c C-x	Prefix Command
C-x c ESC	Prefix Command
C-x c /		helm-find
C-x c 8		helm-ucs
C-x c @		helm-list-elisp-packages
C-x c F		helm-select-xfont
C-x c I		helm-imenu-in-all-buffers
C-x c a		helm-apropos
C-x c b		helm-resume
C-x c c		helm-colors
C-x c e		helm-etags-select
C-x c f		helm-multi-files
C-x c h		Prefix Command
C-x c i		helm-semantic-or-imenu
C-x c l		helm-locate
C-x c m		helm-man-woman
C-x c p		helm-list-emacs-process
C-x c r		helm-regexp
C-x c s		helm-surfraw
C-x c t		helm-top
C-x c C-,	helm-calcul-expression
C-x c C-:	helm-eval-expression-with-eldoc
C-x c <tab>	helm-lisp-completion-at-point

C-x r C-@	point-to-register
C-x r ESC	Prefix Command
C-x r SPC	point-to-register
C-x r +		increment-register
C-x r N		rectangle-number-lines
C-x r b		bookmark-jump
C-x r c		clear-rectangle
C-x r d		delete-rectangle
C-x r f		frameset-to-register
C-x r g		insert-register
C-x r i		insert-register
C-x r j		jump-to-register
C-x r k		kill-rectangle
C-x r l		bookmark-bmenu-list
C-x r m		bookmark-set
C-x r n		number-to-register
C-x r o		open-rectangle
C-x r r		copy-rectangle-to-register
C-x r s		copy-to-register
C-x r t		string-rectangle
C-x r w		window-configuration-to-register
C-x r x		copy-to-register
C-x r y		yank-rectangle
C-x r C-SPC	point-to-register

C-x v +		vc-update
C-x v =		vc-diff
C-x v D		vc-root-diff
C-x v G		vc-ignore
C-x v I		vc-log-incoming
C-x v L		vc-print-root-log
C-x v O		vc-log-outgoing
C-x v a		vc-update-change-log
C-x v b		vc-switch-backend
C-x v c		vc-rollback
C-x v d		vc-dir
C-x v g		vc-annotate
C-x v h		vc-insert-headers
C-x v i		vc-register
C-x v l		vc-print-log
C-x v m		vc-merge
C-x v r		vc-retrieve-tag
C-x v s		vc-create-tag
C-x v u		vc-revert
C-x v v		vc-next-action
C-x v ~		vc-revision-other-window

C-z M-t		bm-show-all

M-s h .		highlight-symbol-at-point
M-s h f		hi-lock-find-patterns
M-s h l		highlight-lines-matching-regexp
M-s h p		highlight-phrase
M-s h r		highlight-regexp
M-s h u		unhighlight-regexp
M-s h w		hi-lock-write-interactive-patterns

M-o M-S		center-paragraph
M-o M-o		font-lock-fontify-block
M-o M-s		center-line

M-g M-g		goto-line
M-g M-n		next-error
M-g M-p		previous-error

C-x a i g	inverse-add-global-abbrev
C-x a i l	inverse-add-mode-abbrev

C-x c h g	helm-info-gnus
C-x c h h	helm-documentation
C-x c h i	helm-info-at-point
C-x c h r	helm-info-emacs

C-x c C-c C-x	helm-run-external-command
C-x c C-c SPC	helm-all-mark-rings
C-x c C-c f	helm-recentf
C-x c C-c g	helm-google-suggest

C-x c M-g	Prefix Command
C-x c M-s	Prefix Command
C-x c M-x	helm-M-x
C-x c M-y	helm-show-kill-ring

C-x c M-s o	helm-occur

C-x c M-g a	helm-do-grep-ag
C-x c M-g i	helm-gid

C-x c C-x C-b	helm-buffers-list
C-x c C-x C-f	helm-find-files
C-x c C-x r	Prefix Command

C-x r M-w	copy-rectangle-as-kill

C-x c C-x r b	helm-filtered-bookmarks
C-x c C-x r i	helm-register

C-x @		Prefix Command

C-x @ S		event-apply-shift-modifier
C-x @ a		event-apply-alt-modifier
C-x @ c		event-apply-control-modifier
C-x @ h		event-apply-hyper-modifier
C-x @ m		event-apply-meta-modifier
C-x @ s		event-apply-super-modifier
